1111111111111
10010C000000C1
1000011111001
1P0011E0001001
1111111111111