1111111
1000001
0000001
1000001
1111111