1111111
1000001
1000000
1000001
1111111