1111111
1000001
1000001
1000001
1110111