11111111
100100C1
10000001
1P00E001
11111111